111111111111111111111
1E0000000C00000C00001
101000100010100110101
101010101000100110101
1P000C00C0000000000C1
111111111111111111111
